11111111111111
1P0001000E1111
10000111111101
100000C0000001
10000000000001
10000000000001
11111111111111
