11111111111111
1P000C000E1111
10000000C00001
10000EC0000001
10000000000001
10000000000001
11111111111111
