11111111111111
11111111111111
1111E111111101
11C00P00011101
11111011111101
11111111111111
