1111111111111111111
1P0000000000110C001
1111E00000000111111
110010000C000100011
1111100100010100011
1000000000000000001
1111111111111111111
